#,#,#,#,#,#,#,#,#,#,#,#,#,#,#,#,#,#,#,#,#,#,#,#,#,#,#,#,#,#,#,#
#,$, , , , , , , , , , , , , , ,$,#,$, , , , , , , , , , , ,$,#
#, , , , , , , , , , , , , , , , ,#, , , , , , , , , , , , , ,#
#, , , , , , , , , , , , , , , , ,#, , , , , , , , , , , , , ,#
#, , , , , , ,#,#,#,#, , , , , , ,#, , , ,#,#,#,#, , , , , , ,#
#, , , , , , ,#,$, , , , , , , , , , , , , , ,$,#, , , , , , ,#
#, , , , , ,$,#, , , , , , , , , , , , , , , , ,#,$, , , , , ,#
#, , , ,#,#,#,#, , , , , , , , , , , , , , , , ,#,#,#,#, , , ,#
#, , , ,#,$, , , , , ,#,#,#,#, , , , , ,@, , , , , ,$,#, , , ,#
#, , , ,#, , , , , , , , ,$,#, , , , , , , , , , , , ,#, , , ,#
#, , , ,#, , , , , , , , , ,#,$, , , , , , , , , , , ,#, , , ,#
#, , , , , , , ,@, , , , , ,#,#,#,#, , , , , ,#, , , , , , , ,#
#, , , , , , , , , , , , , , , , , , , , , , ,#, , , , , , , ,#
#,$, , , , , , , , , , , , , , , , , , , , ,$,#, , , , , , , ,#
#,#,#,#,#, , , , , , ,#, , , , , , , , ,#,#,#,#, , , , , , , ,#
#,$, , , , , , , , , ,#, , , , , , , , ,#,$, , , , , , , , , ,#
#, , , , , , , , , ,$,#, , , , , , , , ,#, , , , , , , , , ,$,#
#, , , , , , , ,#,#,#,#, , , , , , , , ,#, , , , , , ,#,#,#,#,#
#, , , , , , , ,#,$, , , , , , , , , , , , , , , , , , , , ,$,#
#, , , , , , , ,#, , , , , , , , , , , , , , , , , , , , , , ,#
#, , , , , , , ,#, , , , , ,#,#,#,#, , , , , ,@, , , , , , , ,#
#, , , ,#, , , , , , , , , , , ,$,#, , , , , , , , , ,#, , , ,#
#, , , ,#, , , , , , , , , , , , ,#,$, , , , , , , , ,#, , , ,#
#, , , ,#,$, , , , , ,@, , , , , ,#,#,#,#, , , , , ,$,#, , , ,#
#, , , ,#,#,#,#, , , , , , , , , , , , , , , , ,#,#,#,#, , , ,#
#, , , , , ,$,#, , , , , , , , , , , , , , , , ,#,$, , , , , ,#
#, , , , , , ,#,$, , , , , , , , , , , , , , ,$,#, , , , , , ,#
#, , , , , , ,#,#,#,#, , , ,#, , , , , , ,#,#,#,#, , , , , , ,#
#, , , , , , , , , , , , , ,#, , , , , , , , , , , , , , , , ,#
#, , , , , , , , , , , , , ,#, , , , , , , , , , , , , , , , ,#
#,$, , , , , , , , , , , ,$,#,$, , , , , , , , , , , , , , ,$,#
#,#,#,#,#,#,#,#,#,#,#,#,#,#,#,#,#,#,#,#,#,#,#,#,#,#,#,#,#,#,#,#
