#,#,#,#,#,#,#,#,#,#,#,#,#,#,#,#,#,#,#,#,#,#,#,#,#,#,#,#,#,#,#,#
#,$, , , , , , , , , , , , , , , , , , , , , , , , , , , , ,$,#
#, , , , , , , , , , , , , , , , , , , , , , , , , , , , , , ,#
#, , , , , , , , , , , , , , , , , , , , , ,$, , , , , , , , ,#
#, , , , , ,$, , , , , ,$, , , , , , , , , , , , , , , , , , ,#
#, , , , , , , , , , , , , , , , , , , , , , , , , , , , , , ,#
#, , , , , , , , , , , , , , , , , , , , , , , , , , ,$, , , ,#
#, , , , , , , , , , , , , , , , ,$, , , , , , , , , , , , , ,#
#, , , , , , , , , , , , , , , , , , , , , , , , , , , , , , ,#
#, , ,$, , , , , ,@, , , , , , , , , , , , ,@, , , , , , , , ,#
#, , , , , , , , , , , , , , , , , , , , , , , , , , , , , , ,#
#, , , , , , , , , , , , , , , , , , , , , , , , , , ,$, , , ,#
#, , , , , , , , , , , , , ,$, , , , , , , , , , , , , , , , ,#
#, , , , , , , , , , , , , , , , , , , , , , , , , , , , , , ,#
#, , , , , ,$, , , , , , , , , , , , ,$, , , , , , , , , , , ,#
#, , , , , , , , , , , , , , , , , , , , , , , , , , , , , , ,#
#, , , , , , , , , , , , , , , , , , , , , , , , , , , , , , ,#
#, , , , , , , , , , , ,$, , , , , , , , , , , , ,$, , , , , ,#
#, , , , , , , , , , , , , , , , , , , , , , , , , , , , , , ,#
#, , , ,$, , , , , , , , , , , , ,$, , , , , , , , , , , , , ,#
#, , , , , , , , , , , , , , , , , , , , , , , , , , , , , , ,#
#, , , , , , , , , , , , , , , , , , , , , , , , , , , , , , ,#
#, , , , , , , , ,@, , , , , , , , , , , , ,@, , , , , ,$, , ,#
#, , , , , , , , , , , , , , , , , , , , , , , , , , , , , , ,#
#, , , ,$, , , , , , , , , , , , , , , , , , , , , , , , , , ,#
#, , , , , , , , , , , , , ,$, , , , , , , , , , , , , , , , ,#
#, , , , , , , , , , , , , , , , , , , , , , , , , , , , , , ,#
#, , , , , , , , , , , , , , , , , , ,$, , , , , ,$, , , , , ,#
#, , , , , , , , ,$, , , , , , , , , , , , , , , , , , , , , ,#
#, , , , , , , , , , , , , , , , , , , , , , , , , , , , , , ,#
#,$, , , , , , , , , , , , , , , , , , , , , , , , , , , , ,$,#
#,#,#,#,#,#,#,#,#,#,#,#,#,#,#,#,#,#,#,#,#,#,#,#,#,#,#,#,#,#,#,#
