#,#,#,#,#,#,#,#,#,#,#,#,#,#,#,#,#,#,#,#,#,#,#,#,#,#,#,#,#,#,#,#
#,@, , , , , , ,#,$, , , , , , ,#, , , , , ,#, , , , , , ,#,@,#
#,#,#,#,#,#,#, ,#,#,#,#,#,#,#, ,#, ,#,#,#, ,#, ,#,#,#,#, ,#, ,#
#, , , , , , , , , , , , , ,#, ,#, ,#,$,#, ,#, , , , ,#, ,#, ,#
#, ,#,#,#,#,#,#,#,#,#,#,#, ,#, ,#, ,#, ,#, ,#,#,#,#, ,#, ,#, ,#
#, ,#, , , ,#, , , , , , , , , , , ,#, , , , , , , , ,#, ,#, ,#
#, ,#, ,#, ,#, ,#,#,#, ,#,#,#,#,#,#,#, ,#,#,#,#,#,#,#,#, ,#, ,#
#, ,#, ,#, ,#, ,#,$,#, ,#, , , ,#, , , , , , , , , , ,#, , , ,#
#, , , ,#, ,#, ,#, ,#, ,#, ,#, ,#, ,#,#,#,#,#,#,#,#, ,#, ,#,#,#
#,#,#,#,#, ,#, ,#, , , , , ,#, , , ,$,#, , , , ,$,#, ,#, ,#,$,#
#, , , , , ,#, ,#, ,#,#,#,#,#, ,#,#,#,#, ,#, ,#,#,#, ,#, ,#, ,#
#, ,#,#,#, ,#, ,#, , , ,#,$,#, , , , , , ,#, , , , , ,#, ,#, ,#
#, ,#,$, , , , ,#,#,#, ,#, , , ,#, ,#,#,#,#, ,#,#,#, ,#, ,#, ,#
#, ,#,#,#,#,#, ,#,$,#, ,#,#,#,#,#, ,#, ,$,#, , , ,#, , , ,#, ,#
#, , , , , ,#, , , ,#, , , , ,$,#, ,#, ,#,#,#,#, ,#, ,#,#,#, ,#
#,#,#,#,#, ,#,#,#, ,#, ,#,#,#,#,#,$,#, , , , , , ,#, , , , , ,#
#, , , , , ,#, , , , , , ,#,$,#,#,#,#,#, ,#, ,#,#,#, ,#,#,#,#,#
#, ,#,#,#, ,#, ,#,#,#,#, ,#, ,#,$, , , , ,#, , , ,#, , , , , ,#
#, ,#, , , ,#, , , ,#,$, ,#, ,#,#,#,#,#, ,#,$,#, ,#,#,#,#,#, ,#
#, ,#, ,#, ,#,#,#, ,#,#,#,#, ,#, , , ,#, ,#,#,#, , , , ,$,#, ,#
#, ,#, ,#, , , , , ,#, , , , , , ,#,$,#, , , ,#, ,#, ,#,#,#, ,#
#, ,#, ,#, ,#,#,#, ,#, ,#,#,#,#, ,#,#,#,#,#, ,#, ,#, , , , , ,#
#,$,#, ,#, ,#,$, , , , ,#,$, , , ,#, , , , , ,#, ,#, ,#,#,#,#,#
#,#,#, ,#, ,#,#,#,#,#,#,#,#, ,#, ,#, ,#, ,#, ,#, ,#, ,#, , , ,#
#, , , ,#, , , , , , , , , , ,#, , , ,#, ,#,$,#, ,#, ,#, ,#, ,#
#, ,#, ,#,#,#,#,#,#,#,#, ,#,#,#,#,#,#,#, ,#,#,#, ,#, ,#, ,#, ,#
#, ,#, ,#, , , , , , , , ,#, , , , , , , , , , , ,#, , , ,#, ,#
#, ,#, ,#, ,#,#,#,#, ,#, ,#, ,#, ,#, ,#,#,#,#,#,#,#,#,#,#,#, ,#
#, ,#, ,#, , , , ,#, ,#,$,#, ,#, ,#, , , , , , , , , , , , , ,#
#, ,#, ,#,#,#,#, ,#, ,#,#,#, ,#, ,#,#,#,#,#,#,#, ,#,#,#,#,#,#,#
#,@,#, , , , , , ,#, , , , , ,#, , , , , , ,$,#, , , , , , ,@,#
#,#,#,#,#,#,#,#,#,#,#,#,#,#,#,#,#,#,#,#,#,#,#,#,#,#,#,#,#,#,#,#
