#,#,#,#,#,#,#,#,#,#,#,#,#,#,#,#,#,#,#,#,#,#,#,#,#,#,#,#,#,#,#,#
#,$, , , , , , , , , , ,$,#,$, , , , , , , , ,$,#,$, , , , ,$,#
#, , , , , , , , , , , , ,#, , , , , , , , , , ,#, , , , , , ,#
#, , , , , , , , , , , , ,#, , , , , , , , , , ,#, , , , , , ,#
#, , , , , ,#,#,#,#, , , , , , , ,#,#,#,#, , , , , , , , , , ,#
#, , , , , , , ,$,#, , , , , , , , , ,$,#, , , , , , , , , , ,#
#,$, , , , , , , ,#,$, , , , , , , , , ,#, , , , , , ,#, , , ,#
#,#,#,#, , , , , ,#,#,#,#, , , , , , , ,#, , , , , , ,#, , , ,#
#,$, , , , , , , , , , , , , , ,#, , , , , , , , , ,$,#, , , ,#
#, , , , , , , , , , , , , , , ,#, , , , , , , ,#,#,#,#, , , ,#
#, , , , , , , , , , , , , , , ,#, , , , , , , ,#,$, , , , , ,#
#, , , ,#,#,#,#, , , , , , , , ,#, , , , , , , ,#, , , , , , ,#
#, , , ,#,$, , , , , , , , , , ,#, , , , , , , ,#, , , , , ,$,#
#, , , ,#, , , , , , , , , , , ,#, , , , , , , , , , , ,#,#,#,#
#, , , ,#, , , , , , , , , , ,@,#, , , , , , , , , , , , , ,$,#
#, , , , , , , ,#,#,#,#,#,#,#,#,#,@, , , , , , , , , , , , , ,#
#, , , , , , , , , , , , , ,@,#,#,#,#,#,#,#,#,#, , , , , , , ,#
#,$, , , , , , , , , , , , , ,#,@, , , , , , , , , , ,#, , , ,#
#,#,#,#, , , , , , , , , , , ,#, , , , , , , , , , , ,#, , , ,#
#,$, , , , , ,#, , , , , , , ,#, , , , , , , , , , ,$,#, , , ,#
#, , , , , , ,#, , , , , , , ,#, , , , , , , , ,#,#,#,#, , , ,#
#, , , , , ,$,#, , , , , , , ,#, , , , , , , , , , , , , , , ,#
#, , , ,#,#,#,#, , , , , , , ,#, , , , , , , , , , , , , , , ,#
#, , , ,#,$, , , , , , , , , ,#, , , , , , , , , , , , , , ,$,#
#, , , ,#, , , , , , ,#, , , , , , , ,#,#,#,#, , , , , ,#,#,#,#
#, , , ,#, , , , , , ,#, , , , , , , , , ,$,#, , , , , , , ,$,#
#, , , , , , , , , , ,#,$, , , , , , , , , ,#,$, , , , , , , ,#
#, , , , , , , , , , ,#,#,#,#, , , , , , , ,#,#,#,#, , , , , ,#
#, , , , , , ,#, , , , , , , , , , ,#, , , , , , , , , , , , ,#
#, , , , , , ,#, , , , , , , , , , ,#, , , , , , , , , , , , ,#
#,$, , , , ,$,#,$, , , , , , , , ,$,#,$, , , , , , , , , , ,$,#
#,#,#,#,#,#,#,#,#,#,#,#,#,#,#,#,#,#,#,#,#,#,#,#,#,#,#,#,#,#,#,#
